{
  "1": "1",
  "2": "2",
  "3": "3",
  "4": "4",
  "5": "5",
  "6": "6",
  "7": "7",
  "8": "8",
  "9": "9",
  "0": "0",
  "-": "-",
  "=": "=",
  "q": ";",
  "w": "ς",
  "e": "ε",
  "r": "ρ",
  "t": "τ",
  "y": "υ",
  "u": "θ",
  "i": "ι",
  "o": "ο",
  "p": "π",
  "[": "[",
  "]": "]",
  "\\": "\\",
  "a": "α",
  "s": "σ",
  "d": "δ",
  "f": "φ",
  "g": "γ",
  "h": "η",
  "j": "ξ",
  "k": "κ",
  "l": "λ",
  ";": "΄",
  "'": "'",
  "z": "ζ",
  "x": "χ",
  "c": "ψ",
  "v": "ω",
  "b": "β",
  "n": "ν",
  "m": "μ",
  ",": ",",
  ".": ".",
  "/": "/",
  "!": "!",
  "@": "@",
  "#": "#",
  "$": "$",
  "%": "%",
  "^": "^",
  "&": "&",
  "*": "*",
  "(": "(",
  ")": ")",
  "_": "_",
  "+": "+",
  "Q": ":",
  "W": "΅",
  "E": "Ε",
  "R": "Ρ",
  "T": "Τ",
  "Y": "Υ",
  "U": "Θ",
  "I": "Ι",
  "O": "Ο",
  "P": "Π",
  "{": "{",
  "}": "}",
  "|": "|",
  "A": "Α",
  "S": "Σ",
  "D": "Δ",
  "F": "Φ",
  "G": "Γ",
  "H": "Η",
  "J": "Ξ",
  "K": "Κ",
  "L": "Λ",
  ":": "¨",
  "\"": "\"",
  "Z": "Ζ",
  "X": "Χ",
  "C": "Ψ",
  "V": "Ω",
  "B": "Β",
  "N": "Ν",
  "M": "Μ",
  "<": "<",
  ">": ">",
  "?": "?"
}
